                       
                       
                       
                       
         ##########    
         #.......K#    
         #........#    
         #........#    
         #........#    
         #........#    
    ######........#    
    #.............#    
    >.............#    
    #.............#    
    ######........#    
         #........#    
         #........#    
         #........#    
         #........#    
         #.......K#    
         ##>#######    
                       
                       
                       
                       
