                       
                       
                       
                       
    ###############    
    #............T#    
    #.............#    
    #.............#    
    #.............#    
    #.............#    
    #.............#    
    #.............#    
    #.____________>    
    #.............#    
    #.............#    
    #.............#    
    #.............#    
    #.............#    
    #.............#    
    #............T#    
    ###############    
                       
                       
                       
                       
