             
             
             
             
    ##>##    
    #F.F#    
    #...#    
    #...#    
    #...#    
    #...#    
    #...#    
    #...#    
    #...#    
    #...#    
    #...#    
    #...#    
    #...#    
    #...#    
    #...#    
    #T.T#    
    ##>##    
             
             
             
             
